-1 10 20
####################
#p   # # # # # # # #
#                  #
#    # # # # # # # #
#                  #
#    # # # # # # # #
#    #             #
#    # # # # # # # #
#    #            4#
####################