1 13 31
###############################
#p     bf b  1 * 2 *  * * *   #
# # # #*# # #*#*# # # #*#*#*# #
#  xf     *b*  *  1   * 2 * * #
# # # # # #*# # #*#*# # # # #*#
#f         x **  *  *   1     #
# # # # # # # # # #*# #*# # # #
#s  s      *  *      *        #
# # # # #*# # # #*#*# # # # # #
#*    **  *       *           #
# #*# # # # # # #*# # # # # # #
#           *   *  *          #
###############################
