0 13 31
###############################
#p     bf b  1 * 3 *  * * *   #
# # # #*# # #*#*# # # #*#*#*# #
#  xf     *b*  *  1   * 2 * * #
# # # # # #*# # #*#*# # # # #*#
#f         x **  *  *   1     #
# # # # # # # # # #*# #*# # # #
#s  s      *  *      *        #
# # # # #*# # # #*#*# # # # # #
#*    **  *       *      3    #
# #*# # # # # # #*# # # # # # #
#      3    *   *  *          #
###############################
