0 13 31
###############################
#p                            #
# # # # # # # # # # # # # # # #
#                             #
# # ####### # # # # # # # # # #
#   #                         #
# # # # # # # # # # # # # # # #
#   #                         #
# # # # # # # # # # # # # # # #
#   #                         #
# # # # # # # # # # # # # # # #
#                             #
###############################
